0001000100g
00010p01000
00000p00000
00010p01000
10111101011
00010001000
00010001000
0p00000000p
00010001000
